,지역,휘발유,경유,전기,하이브리드,합계,연도,월별
0,서울,1590654,746540,9514,74700,2421408,2019,1
1,부산,649846,341773,1522,22453,1015594,2019,1
2,대구,554243,289281,6885,20675,871084,2019,1
3,인천,717873,459231,1298,29858,1208260,2019,1
4,광주,290543,165157,1446,10407,467553,2019,1
5,대전,321875,158724,1355,10167,492121,2019,1
6,울산,277016,146853,862,7941,432672,2019,1
7,세종,73797,40225,398,3967,118387,2019,1
8,경기,2660256,1462469,6429,110319,4239473,2019,1
9,강원,321992,189638,1386,10799,523815,2019,1
10,충북,350456,197540,1196,10810,560002,2019,1
11,충남,467523,264735,1140,14141,747539,2019,1
12,전북,366034,225552,1005,11412,604003,2019,1
13,전남,381498,252481,1989,11408,647376,2019,1
14,경북,605485,307718,2008,16653,931864,2019,1
15,경남,789261,399582,2112,21429,1212384,2019,1
16,제주,224743,146852,15181,8846,395622,2019,1
17,전국,10643095,5794351,55726,395985,16889157,2019,1
18,서울,1591333,746705,9589,75812,2423439,2019,2
19,부산,651190,344125,1535,22908,1019758,2019,2
20,대구,553505,289728,6927,20993,871153,2019,2
21,인천,720914,459604,1341,30503,1212362,2019,2
22,광주,290497,165491,1462,10560,468010,2019,2
23,대전,321544,158804,1353,10313,492014,2019,2
24,울산,277029,147248,864,8064,433205,2019,2
25,세종,74621,40741,410,4068,119840,2019,2
26,경기,2666049,1458407,6509,112292,4243257,2019,2
27,강원,322543,189976,1416,10934,524869,2019,2
28,충북,351047,198449,1206,10964,561666,2019,2
29,충남,468457,265764,1159,14348,749728,2019,2
30,전북,366274,226356,1017,11615,605262,2019,2
31,전남,382026,252726,1991,11571,648314,2019,2
32,경북,605848,308832,2034,16902,933616,2019,2
33,경남,788889,398929,2198,21638,1211654,2019,2
34,제주,225779,148068,15150,9000,397997,2019,2
35,전국,10657545,5799953,56161,402485,16916144,2019,2
36,서울,1592543,744168,9876,77216,2423803,2019,3
37,부산,651839,344757,1719,23327,1021642,2019,3
38,대구,553990,290669,7129,21369,873157,2019,3
39,인천,723826,458880,1499,31281,1215486,2019,3
40,광주,290960,166046,1587,10764,469357,2019,3
41,대전,321401,159335,1458,10517,492711,2019,3
42,울산,277232,147712,902,8256,434102,2019,3
43,세종,75389,41191,531,4194,121305,2019,3
44,경기,2675189,1453478,7219,114535,4250421,2019,3
45,강원,323486,189611,1555,11162,525814,2019,3
46,충북,352080,198322,1367,11200,562969,2019,3
47,충남,469551,266111,1557,14589,751808,2019,3
48,전북,367338,226221,1195,11852,606606,2019,3
49,전남,383042,253176,2506,11876,650600,2019,3
50,경북,606644,309554,2395,17239,935832,2019,3
51,경남,789763,398559,2589,21943,1212854,2019,3
52,제주,227080,149536,15476,9186,401278,2019,3
53,전국,10681353,5797326,60560,410506,16949745,2019,3
54,서울,1594756,739748,10113,78778,2423395,2019,4
55,부산,652637,344652,1838,23798,1022925,2019,4
56,대구,553998,288576,7464,21778,871816,2019,4
57,인천,728026,458032,1680,32275,1220013,2019,4
58,광주,291395,165935,1736,10986,470052,2019,4
59,대전,321476,159264,1611,10700,493051,2019,4
60,울산,277399,147943,927,8438,434707,2019,4
61,세종,76019,41305,638,4327,122289,2019,4
62,경기,2684019,1451514,7801,117146,4260480,2019,4
63,강원,324404,189705,1711,11371,527191,2019,4
64,충북,353710,200764,1685,11422,567581,2019,4
65,충남,470481,265962,2048,14855,753346,2019,4
66,전북,367766,226561,1418,12129,607874,2019,4
67,전남,384200,253631,2679,12188,652698,2019,4
68,경북,607565,309625,2754,17581,937525,2019,4
69,경남,791292,399202,2762,22335,1215591,2019,4
70,제주,229054,150285,15945,9415,404699,2019,4
71,전국,10708197,5792704,64810,419522,16985233,2019,4
72,서울,1595300,736941,10539,80460,2423240,2019,5
73,부산,653716,345300,2017,24288,1025321,2019,5
74,대구,554423,288637,7953,22133,873146,2019,5
75,인천,733688,457393,1831,33334,1226246,2019,5
76,광주,291946,165942,1870,11217,470975,2019,5
77,대전,321790,158813,1776,10899,493278,2019,5
78,울산,277835,147573,959,8604,434971,2019,5
79,세종,76469,41482,724,4429,123104,2019,5
80,경기,2693410,1454000,8469,119734,4275613,2019,5
81,강원,325296,190049,1817,11575,528737,2019,5
82,충북,354669,200994,1863,11647,569173,2019,5
83,충남,471293,266495,2243,15097,755128,2019,5
84,전북,368681,227164,1490,12360,609695,2019,5
85,전남,384990,253801,2809,12407,654007,2019,5
86,경북,608367,310415,2962,17882,939626,2019,5
87,경남,792769,400304,2974,22778,1218825,2019,5
88,제주,230714,151744,16467,9665,408590,2019,5
89,전국,10735356,5797047,68763,428509,17029675,2019,5
90,서울,1594758,735110,11007,81966,2422841,2019,6
91,부산,654742,346188,2162,24717,1027809,2019,6
92,대구,554799,289145,8295,22547,874786,2019,6
93,인천,739558,457132,1973,34507,1233170,2019,6
94,광주,292420,165972,2023,11399,471814,2019,6
95,대전,321967,158595,1931,11119,493612,2019,6
96,울산,278123,147687,1019,8769,435598,2019,6
97,세종,77011,41774,796,4534,124115,2019,6
98,경기,2702061,1458962,9166,122278,4292467,2019,6
99,강원,326020,190618,1929,11800,530367,2019,6
100,충북,355475,201486,1954,11885,570800,2019,6
101,충남,472096,267164,2303,15383,756946,2019,6
102,전북,369308,227770,1586,12576,611240,2019,6
103,전남,385759,254729,2971,12645,656104,2019,6
104,경북,609001,311296,3150,18244,941691,2019,6
105,경남,794151,401593,3072,23184,1222000,2019,6
106,제주,232870,153016,16981,9979,412846,2019,6
107,전국,10760119,5808237,72318,437532,17078206,2019,6
108,서울,1595720,734677,11688,83297,2425382,2019,7
109,부산,655333,346354,2338,25142,1029167,2019,7
110,대구,555183,289571,8644,22912,876310,2019,7
111,인천,744491,458204,2119,35778,1240592,2019,7
112,광주,293040,166329,2139,11662,473170,2019,7
113,대전,322273,158617,2111,11291,494292,2019,7
114,울산,278325,148066,1079,8900,436370,2019,7
115,세종,77732,42181,807,4646,125366,2019,7
116,경기,2711142,1463878,9776,124718,4309514,2019,7
117,강원,326824,191197,2098,12010,532129,2019,7
118,충북,356484,202128,2055,12113,572780,2019,7
119,충남,472997,267753,2413,15628,758791,2019,7
120,전북,369929,227702,1641,12825,612097,2019,7
121,전남,386783,255134,3069,12866,657852,2019,7
122,경북,609517,312188,3400,18556,943661,2019,7
123,경남,795869,402901,3223,23620,1225613,2019,7
124,제주,235426,154474,17231,10460,417591,2019,7
125,전국,10787068,5821354,75831,446424,17130677,2019,7
126,서울,1597340,734030,11973,83915,2427258,2019,8
127,부산,656628,346911,2417,25398,1031354,2019,8
128,대구,556107,289956,9041,23251,878355,2019,8
129,인천,746204,457559,2197,36311,1242271,2019,8
130,광주,293693,166512,2212,11784,474201,2019,8
131,대전,322545,158531,2218,11433,494727,2019,8
132,울산,278565,148338,1123,8971,436997,2019,8
133,세종,78354,42485,822,4713,126374,2019,8
134,경기,2720895,1466639,10192,126357,4324083,2019,8
135,강원,327742,191735,2215,12156,533848,2019,8
136,충북,357388,202653,2087,12258,574386,2019,8
137,충남,474011,268314,2482,15765,760572,2019,8
138,전북,370666,228142,1700,12991,613499,2019,8
139,전남,387665,255791,3113,12984,659553,2019,8
140,경북,610086,313237,3554,18788,945665,2019,8
141,경남,797343,403621,3352,23880,1228196,2019,8
142,제주,238064,155245,17439,10638,421386,2019,8
143,전국,10813296,5829699,78137,451593,17172725,2019,8
144,서울,1599215,733133,12310,84882,2429540,2019,9
145,부산,658200,347345,2492,25752,1033789,2019,9
146,대구,557273,290320,9381,23544,880518,2019,9
147,인천,749853,456411,2309,36888,1245461,2019,9
148,광주,294350,166775,2281,11939,475345,2019,9
149,대전,323016,158674,2297,11574,495561,2019,9
150,울산,278919,148481,1169,9155,437724,2019,9
151,세종,78881,42760,853,4808,127302,2019,9
152,경기,2732692,1460493,10526,128528,4332239,2019,9
153,강원,328855,191932,2318,12372,535477,2019,9
154,충북,358340,203199,2126,12442,576107,2019,9
155,충남,475504,269109,2542,16019,763174,2019,9
156,전북,371589,228023,1752,13192,614556,2019,9
157,전남,389250,256166,3250,13210,661876,2019,9
158,경북,610903,314244,3661,19076,947884,2019,9
159,경남,799358,404886,3411,24300,1231955,2019,9
160,제주,240086,155493,17659,10894,424132,2019,9
161,전국,10846284,5827444,80337,458575,17212640,2019,9
162,서울,1600739,731425,12626,86164,2430954,2019,10
163,부산,658527,346692,2550,26113,1033882,2019,10
164,대구,559240,290612,9711,23907,883470,2019,10
165,인천,754005,456354,2398,37640,1250397,2019,10
166,광주,294869,166778,2330,12126,476103,2019,10
167,대전,323334,158687,2355,11780,496156,2019,10
168,울산,279160,148063,1198,9351,437772,2019,10
169,세종,79620,43183,863,4956,128622,2019,10
170,경기,2743057,1456402,10867,131045,4341371,2019,10
171,강원,329646,191054,2364,12615,535679,2019,10
172,충북,359581,203232,2253,12641,577707,2019,10
173,충남,476609,269077,2640,16335,764661,2019,10
174,전북,372601,226138,1804,13451,613994,2019,10
175,전남,390819,256494,3269,13486,664068,2019,10
176,경북,611610,313874,3823,19470,948777,2019,10
177,경남,800681,403027,3530,24720,1231958,2019,10
178,제주,242068,156168,17813,11242,427291,2019,10
179,전국,10876166,5817260,82394,467042,17242862,2019,10
180,서울,1603241,729247,13510,87480,2433478,2019,11
181,부산,660501,347498,2835,26594,1037428,2019,11
182,대구,560360,290882,10598,24355,886195,2019,11
183,인천,757760,455638,2488,38387,1254273,2019,11
184,광주,295347,166785,2378,12338,476848,2019,11
185,대전,324140,158310,2419,12013,496882,2019,11
186,울산,279707,147850,1398,9509,438464,2019,11
187,세종,80435,43264,874,5095,129668,2019,11
188,경기,2754659,1456018,11208,133536,4355421,2019,11
189,강원,330938,190864,2409,12865,537076,2019,11
190,충북,361216,202543,2349,12914,579022,2019,11
191,충남,477926,268339,2777,16662,765704,2019,11
192,전북,374050,225447,1823,13703,615023,2019,11
193,전남,392846,256237,3294,13746,666123,2019,11
194,경북,613204,313484,3947,19820,950455,2019,11
195,경남,803075,403096,3551,25218,1234940,2019,11
196,제주,244466,157349,17930,11553,431298,2019,11
197,전국,10913871,5812851,85788,475788,17288298,2019,11
198,서울,1604962,727757,14232,89458,2436409,2019,12
199,부산,662103,348752,3090,27275,1041220,2019,12
200,대구,560827,290441,10838,24952,887058,2019,12
201,인천,761823,456270,2570,39286,1259949,2019,12
202,광주,295475,166769,2453,12619,477316,2019,12
203,대전,324863,157988,2543,12411,497805,2019,12
204,울산,280074,148059,1447,9844,439424,2019,12
205,세종,80997,43363,895,5278,130533,2019,12
206,경기,2763256,1457866,11475,136973,4369570,2019,12
207,강원,331663,191065,2423,13190,538341,2019,12
208,충북,362706,201636,2379,13274,579995,2019,12
209,충남,479269,268192,2819,17109,767389,2019,12
210,전북,374940,225923,1835,14017,616715,2019,12
211,전남,394324,256298,3316,14227,668165,2019,12
212,경북,614372,314113,4038,20389,952912,2019,12
213,경남,805186,404049,3548,25905,1238688,2019,12
214,제주,246733,158385,18025,11921,435064,2019,12
215,전국,10943573,5816926,87926,488128,17336553,2019,12
